🔲🔲🔲🔲🔲🔲🔲🔲🔲🔲🔲🔲🔲🔲🔲🔲🔲🔲🔲🔲🔲🔲🔲
🔲🌻⬛⬛🔲⬛⬛⬛🔲🔲⬛🔲🔲⬛⬛⬛⬛⬛🔲⬛⬛⬛🔲
🔲⬛🔲⬛⬛⬛🔲⬛⬛⬛⬛🔲🔲🔲⬛⬛🔲⬛🔲⬛🔲⬛🔲
🔲⬛🔲⬛🔲⬛🔲🔲⬛⬛⬛🔲🔲🔲🔲⬛🔲⬛🔲⬛🔲⬛🔲
🔲🔲🔲⬛🔲🔲🔲🔲🔲🔲⬛⬛🔲🔲🔲⬛🔲⬛⬛⬛🔲⬛🔲
🔲⬛⬛⬛⬛⬛🔲🔲⬛⬛⬛⬛⬛⬛⬛⬛🔲🔲🔲🔲🔲⬛🔲
🔲🔲🔲🔲🔲⬛🔲🔲⬛🔲🔲🔲⬛⬛🔲🔲🔲🔲⬛⬛⬛⬛🔲
🔲⬛⬛⬛⬛⬛🔲⬛⬛🔲🔲🔲🔲⬛🔲🔲🏆⬛⬛🔲⬛⬛🔲
🔲⬛🔲🔲🔲🔲🔲🔲🔲⬛⬛⬛⬛⬛⬛🔲🔲🔲🔲🔲🔲⬛🔲
🔲⬛⬛⬛⬛⬛⬛⬛⬛⬛🔲🔲🔲⬛⬛⬛⬛⬛⬛⬛⬛⬛🔲
🔲🔲🔲🔲🔲🔲🔲🔲🔲🔲🔲🔲🔲🔲🔲🔲🔲🔲🔲🔲🔲🔲🔲
