🔲🔲🔲🔲🔲🔲🔲🔲🔲🔲🔲🔲🔲🔲🔲🔲🔲🔲🔲🔲🔲🔲🔲
🔲🌝⬛⬛🔲⬛⬛⬛🔲🔲⬛🔲🔲⬛⬛⬛⬛⬛🔲⬛⬛⬛🔲
🔲⬛🔲⬛⬛⬛🔲⬛⬛⬛⬛🔲🔲🔲⬛⬛🔲⬛🔲⬛🔲⬛🔲
🔲⬛🔲⬛🔲⬛🔲🔲⬛⬛⬛🔲🔲🔲🔲⬛🔲⬛🔲⬛🔲⬛🔲
🔲🔲🔲⬛🔲🔲🔲🔲🔲🔲⬛⬛🔲🔲🔲⬛🔲⬛⬛⬛🔲⬛🔲
🔲⬛⬛⬛⬛⬛🔲🔲⬛⬛⬛⬛⬛⬛⬛⬛🔲🔲🔲🔲🔲⬛🔲
🔲🔲🔲🔲🔲⬛🔲🔲⬛🔲🔲🔲⬛⬛🔲🔲🔲🔲⬛⬛⬛⬛🔲
🔲⬛⬛⬛⬛⬛🔲⬛⬛🔲🔲🔲🔲⬛🔲🔲🏆⬛⬛🔲⬛⬛🔲
🔲⬛🔲🔲🔲🔲🔲🔲🔲⬛⬛⬛⬛⬛⬛🔲🔲🔲🔲🔲🔲⬛🔲
🔲⬛⬛⬛⬛⬛⬛⬛⬛⬛🔲🔲🔲⬛⬛⬛⬛⬛⬛⬛⬛⬛




🔲
🔲🔲🔲🔲🔲🔲🔲🔲🔲🔲🔲🔲🔲🔲🔲🔲🔲🔲🔲🔲🔲🔲🔲
