🔲🔲🔲🔲🔲🔲🔲🔲🔲🔲🔲🔲🔲🔲🔲🔲🔲🔲🔲🔲🔲🔲🔲🔲🔲🔲🔲
🔲🌻⬛⬛⬛⬛⬛⬛⬛⬛⬛⬛⬛⬛⬛⬛⬛⬛⬛⬛⬛⬛⬛⬛⬛⬛🔲
🔲⬛🔲🔲🔲🔲⬛🔲🔲🔲🔲🔲⬛⬛⬛⬛🔲🔲🔲🔲🔲🔲🔲🔲⬛⬛🔲
🔲⬛⬛⬛⬛🔲⬛⬛⬛⬛⬛🔲⬛🔲⬛🔲⬛⬛⬛⬛⬛⬛⬛⬛⬛⬛🔲
🔲🔲🔲🔲⬛🔲🔲🔲🔲🔲⬛🔲⬛🔲⬛🔲🔲🔲🔲🔲🔲🔲🔲⬛⬛🔲🔲
🔲⬛⬛⬛⬛⬛⬛⬛⬛🔲⬛⬛⬛⬛⬛⬛⬛⬛⬛⬛🔲⬛⬛🔲⬛⬛🔲
🔲⬛🔲🔲🔲🔲🔲⬛⬛⬛⬛🔲🔲🔲🔲🔲🔲⬛🔲🔲⬛⬛⬛⬛🔲⬛🔲
🔲⬛⬛⬛⬛⬛🔲⬛🔲🔲🔲⬛⬛⬛⬛⬛🔲⬛⬛🔲⬛🔲⬛⬛⬛🔲🔲
🔲🔲🔲🔲🔲⬛🔲⬛⬛⬛🔲⬛🔲🔲🔲⬛⬛⬛🔲⬛⬛🔲🔲⬛⬛⬛🔲
🔲⬛⬛⬛⬛⬛🔲⬛⬛⬛🔲⬛⬛⬛⬛⬛⬛⬛⬛🔲⬛🔲⬛⬛⬛🔲🔲
🔲⬛🔲🔲🔲⬛🔲🔲🔲⬛🔲⬛⬛⬛⬛⬛🔲⬛⬛⬛⬛🔲🔲⬛⬛🔲🔲
🔲⬛⬛⬛⬛⬛⬛⬛🔲⬛⬛⬛⬛⬛⬛⬛🔲⬛⬛⬛🔲⬛⬛🔲⬛⬛🔲
🔲🔲🔲🔲🔲🔲🔲⬛⬛🔲🔲🔲🔲🔲🔲🔲⬛⬛⬛⬛🔲🔲🔲⬛⬛🔲🔲
🔲⬛⬛⬛⬛⬛⬛⬛⬛⬛⬛⬛🔲⬛⬛⬛⬛⬛⬛⬛⬛⬛⬛🔲⬛⬛🔲
🔲⬛🔲🔲🔲🔲🔲🔲🔲🔲⬛⬛🔲⬛🔲🔲🔲🔲🔲🔲🔲🔲🔲⬛🔲⬛🔲
🔲⬛⬛⬛⬛⬛⬛⬛⬛⬛⬛⬛🔲⬛🔲⬛⬛⬛⬛⬛⬛⬛⬛⬛⬛⬛🔲
🔲⬛⬛⬛⬛🔲🔲🔲🔲⬛⬛⬛🔲⬛🔲⬛⬛🔲🔲🔲🔲🔲🔲🔲⬛🔲🔲
🔲⬛⬛⬛⬛🔲⬛⬛⬛⬛⬛⬛🔲🔲⬛⬛⬛⬛⬛⬛⬛⬛⬛🔲⬛⬛🔲
🔲⬛⬛⬛⬛⬛⬛⬛⬛⬛⬛⬛⬛⬛⬛⬛⬛⬛🔲🔲🔲🔲🔲⬛🏆⬛🔲
🔲🔲🔲🔲🔲🔲🔲🔲🔲🔲🔲🔲🔲🔲🔲🔲🔲🔲🔲🔲🔲🔲🔲🔲🔲🔲🔲
