🔲🔲🔲🔲🔲🔲🔲🔲🔲🔲🔲🔲🔲🔲🔲🔲🔲🔲🔲🔲🔲🔲🔲🔲🔲🔲🔲
🔲🌻⬛⬛⬛⬛⬛⬛🔲⬛⬛⬛⬛⬛⬛⬛⬛⬛⬛⬛⬛⬛⬛⬛⬛⬛🔲
🔲⬛🔲🔲🔲🔲⬛🔲⬛🔲🔲🔲⬛⬛🔲⬛⬛🔲⬛🔲⬛⬛🔲🔲⬛⬛🔲
🔲⬛⬛⬛⬛🔲⬛⬛⬛⬛⬛🔲⬛🔲⬛🔲⬛⬛⬛⬛⬛⬛⬛⬛⬛🔲🔲
🔲🔲🔲🔲⬛🔲🔲🔲🔲🔲⬛⬛⬛🔲⬛🔲🔲🔲🔲🔲⬛🔲⬛⬛🔲⬛🔲
🔲⬛⬛⬛⬛⬛⬛⬛⬛🔲⬛🔲⬛⬛⬛⬛🔲⬛⬛⬛⬛🔲⬛⬛🔲⬛🔲
🔲⬛🔲🔲🔲🔲🔲⬛⬛⬛🔲⬛🔲🔲🔲🔲⬛🔲🔲⬛🔲⬛🔲⬛⬛⬛🔲
🔲⬛⬛⬛⬛⬛🔲⬛🔲🔲⬛⬛⬛⬛⬛🔲⬛⬛⬛🔲⬛⬛⬛🔲⬛🔲🔲
🔲🔲🔲🔲🔲⬛🔲⬛🔲⬛⬛⬛🔲⬛⬛⬛⬛⬛⬛🔲⬛⬛🔲⬛⬛⬛🔲
🔲⬛⬛⬛⬛⬛🔲⬛⬛🔲⬛⬛🔲⬛⬛🔲⬛⬛⬛🔲⬛⬛⬛🔲⬛🔲🔲
🔲⬛🔲🔲🔲⬛🔲🔲⬛🔲⬛⬛🔲🔲🔲⬛⬛🔲⬛⬛🔲🔲⬛⬛🔲⬛🔲
🔲⬛⬛⬛⬛⬛⬛⬛⬛⬛🔲⬛⬛⬛🔲⬛⬛🔲⬛🔲🔲⬛⬛⬛⬛⬛🔲
🔲🔲🔲🔲🔲🔲🔲⬛⬛⬛🔲🔲🔲⬛🔲⬛⬛🔲⬛⬛🔲🔲🔲⬛⬛🔲🔲
🔲⬛⬛⬛⬛⬛⬛⬛⬛⬛🔲⬛⬛⬛⬛🔲⬛🔲🔲⬛⬛⬛⬛⬛⬛⬛🔲
🔲⬛🔲🔲🔲🔲🔲🔲🔲🔲⬛🔲⬛🔲⬛🔲🔲🔲⬛⬛🔲🔲⬛🔲⬛⬛🔲
🔲⬛🔲⬛⬛⬛⬛⬛⬛⬛⬛⬛⬛⬛⬛⬛⬛🔲⬛⬛⬛⬛🔲⬛🔲⬛🔲
🔲⬛⬛🔲⬛🔲🔲🔲⬛⬛⬛⬛⬛⬛⬛⬛⬛🔲🔲🔲⬛⬛⬛🔲⬛⬛🔲
🔲⬛🔲⬛⬛🔲⬛⬛⬛⬛⬛⬛⬛⬛⬛⬛⬛⬛🔲⬛⬛⬛⬛⬛🔲⬛🔲
🔲⬛⬛⬛⬛⬛🔲⬛⬛⬛⬛⬛⬛⬛⬛⬛⬛⬛🔲🔲🔲🔲⬛🔲⬛🏆🔲
🔲🔲🔲🔲🔲🔲🔲🔲🔲🔲🔲🔲🔲🔲🔲🔲🔲🔲🔲🔲🔲🔲🔲🔲🔲🔲🔲
