🔲🔲🔲🔲🔲🔲🔲🔲🔲🔲🔲🔲🔲🔲🔲🔲🔲🔲🔲🔲🔲🔲🔲🔲🔲🔲🔲
🔲🌝⬛⬛⬛⬛⬛⬛⬛⬛⬛⬛⬛⬛⬛⬛⬛⬛⬛⬛⬛⬛⬛⬛⬛⬛🔲
🔲⬛🔲🔲🔲🔲⬛🔲🔲🔲🔲🔲⬛⬛⬛⬛🔲🔲🔲🔲🔲🔲🔲🔲⬛⬛🔲
🔲⬛⬛⬛⬛🔲⬛⬛⬛⬛⬛🔲⬛🔲⬛🔲⬛⬛⬛⬛⬛⬛⬛⬛⬛⬛🔲
🔲🔲🔲🔲⬛🔲🔲🔲🔲🔲⬛🔲⬛🔲⬛🔲🔲🔲🔲🔲🔲🔲🔲⬛⬛🔲🔲
🔲⬛⬛⬛⬛⬛⬛⬛⬛🔲⬛⬛⬛⬛⬛⬛⬛⬛⬛⬛⬛⬛⬛🔲⬛⬛🔲
🔲⬛🔲🔲🔲🔲🔲⬛⬛⬛⬛🔲🔲🔲🔲🔲🔲⬛🔲🔲⬛⬛⬛⬛🔲⬛🔲
🔲⬛⬛⬛⬛⬛🔲⬛🔲🔲🔲⬛⬛⬛⬛⬛🔲⬛⬛⬛⬛🔲⬛⬛⬛🔲🔲
🔲🔲🔲🔲🔲⬛🔲⬛⬛⬛🔲⬛🔲🔲🔲⬛⬛⬛⬛⬛⬛🔲⬛⬛⬛⬛🔲
🔲⬛⬛⬛⬛⬛🔲⬛⬛⬛🔲⬛⬛⬛⬛⬛⬛⬛⬛⬛⬛🔲⬛⬛⬛🔲🔲
🔲⬛🔲🔲🔲⬛🔲🔲🔲⬛🔲⬛⬛⬛⬛⬛🔲⬛⬛⬛⬛🔲🔲⬛⬛🔲🔲
🔲⬛⬛⬛⬛⬛⬛⬛🔲⬛⬛⬛⬛⬛⬛⬛🔲⬛⬛⬛🔲⬛⬛⬛⬛⬛🔲
🔲🔲🔲🔲🔲🔲🔲⬛⬛🔲🔲🔲🔲🔲🔲🔲⬛⬛⬛⬛🔲🔲🔲⬛⬛🔲🔲
🔲⬛⬛⬛⬛⬛⬛⬛⬛⬛⬛⬛🔲⬛⬛⬛⬛⬛⬛⬛⬛⬛⬛🔲⬛⬛🔲
🔲⬛🔲🔲🔲🔲🔲🔲🔲🔲⬛⬛🔲⬛⬛⬛🔲🔲🔲🔲🔲🔲🔲⬛🔲⬛🔲
🔲⬛⬛⬛⬛⬛⬛⬛⬛⬛⬛⬛🔲⬛⬛⬛⬛⬛⬛⬛⬛⬛⬛⬛⬛⬛🔲
🔲⬛⬛⬛⬛🔲🔲🔲🔲⬛⬛⬛🔲⬛⬛⬛⬛🔲🔲🔲🔲🔲🔲🔲⬛🔲🔲
🔲⬛⬛⬛⬛🔲⬛⬛⬛⬛⬛⬛🔲⬛⬛⬛⬛⬛⬛⬛⬛⬛⬛🔲⬛⬛🔲
🔲⬛⬛⬛⬛⬛⬛⬛⬛⬛⬛⬛⬛⬛⬛⬛⬛⬛🔲🔲🔲🔲🔲⬛🏆⬛🔲
🔲🔲🔲🔲🔲🔲🔲🔲🔲🔲🔲🔲🔲🔲🔲🔲🔲🔲🔲🔲🔲🔲🔲🔲🔲🔲🔲
